P_caroli1	Phaeo
S__drewei	out
A_agrest1	Antho
A_erectu1	Antho
P_exiguus	Phaeo
Cer_purpu	out
P_himala1	Phaeo
Leio_duss	Leios
Phae_skot	Phame
Ricca_inc	out
M_flagel1	Mega
P__mohrii	Phaeo
A_lamella	Antho
F_amboine	Folio
N_orbicul	Notthy
A_laminif	Antho
D_granula	Den
Parap_dia	Para
Phy___sp1	Phym
S_cristat	out
N_gigante	Notho
D_crispat	Den
P_engelii	Phaeo
M_gracili	Mega
Spha_mage	out
A_erectu2	Antho
A_macouni	Antho
Bry_argen	out
Ric_bicar	out
Ri_natans	out
A_fusifo1	Antho
Tar_hypop	out
A_subtil1	Antho
A_tristan	Antho
N_canalic	Notho
A_sp_nov1	Antho
P_____sp2	Phaeo
P_kashyap	Phaeo
Ric_beyri	out
N_sp_nov2	Notho
M_austron	Mega
N_sp_Nov1	Notho
A_agrest2	Antho
P_himala2	Phaeo
A_maco_sp	Antho
A______sp	Antho
N_levieri	Notthy
A_puncta1	Antho
N_endivi1	Notho
N_vinc_c2	Notho
M_tjibode	Mega
Ricca_lat	out
N_schizop	Notho
Mar_polym	out
Phae_fimb	Phame
N_endivi2	Notho
M_gottsch	out
N_aenigma	Notho
D_cichori	Den
M_forster	out
Phy_cf_bu	Phym
P_perpus1	Phaeo
A_fusifo2	Antho
P_caroli2	Phaeo
N_fuegie1	Notho
A_puncta2	Antho
N_breutel	Notthy
P_cf_laev	Phaeo
P_____sp1	Phaeo
Nototh_sp	Notthy
A_bharadw	Antho
Phae_plic	Phame
P__laevis	Phaeo
A_neesii	Antho
N_fuegie2	Notho
F_argilla	Folio
Phae_cori	Phame
D_acutilo	Den
P_perpus2	Phaeo
A_subtil2	Antho
A_tubercu	Antho
A_cf_agre	Antho
Plag_cord	out
Phy_phyma	Phym
A_caucasi	Antho
F_cf_pinn	Folio
Ano_atten	out
F_fucifo1	Folio
P_evanidu	Phaeo
D_crispus	Den
N_cf_java	Notthy
A_cf_schr	Antho
M_flagel2	Mega
F_fucifo2	Folio
N_endivi3	Notho
